20
01111000
11001100
10000100
10000100
11001100
01111110
00000111
00000011
Lupa
01111110
01111110
01100000
01100000
01111000
01111000
01100000
01100000
F
11100000
01100000
01101000
00111100
00111000
00011111
01100111
11111001
Murciélago
10011001
10111101
01011010
01111110
01000010
00111100
11011011
10000001
Alien 1
00100000
00010000
01010110
10111001
10111101
10111101
10111101
01011010
Calabaza
00001000
00011000
00110100
01101010
11010101
10101011
11010101
01111110
Cagarruta
00000111
00001101
00011001
00111111
01110000
11010000
10010000
11110000
Gafas de corazones
00100100
01111110
11111111
11011011
01111110
01000010
10111101
10000001
Alien 2
01110110
10011001
00101100
01010010
00010000
00100000
00100000
00100000
Palmera
11110000
10101111
11101110
10011100
01111100
10111111
00000110
00000100
Pez
00110000
00011011
00111111
11111100
01111110
11111010
00100000
Tortuga
01000010
00111100
01111110
11011011
11111111
01100110
10100101
10000001
Alien 3
11011111
10011111
00100111
11000011
11000011
11100100
11111001
11111011
Caramelo
11111000
10101111
11111111
11010001
11000000
11000100
11111111
01110000
Cocodrilo
10001111
10010111
11110111
11101100
00000000
00000000
00000001
10000011
Patito
01000010
01100110
00100100
00011000
00111100
01011010
11111111
01100110
Alien 4
00111000
11100100
00100111
11100101
00111001
00000001
01111001
11001111
Enchufe
00000000
01100010
11110111
10110111
01011110
00011111
00011110
00001100
Cisne
00011100
01111110
00011111
00001111
00001111
00100111
11000111
01101110
00111100
Delfin
00100100
01000010
00100100
01111110
10011001
11111111
01100110
10100101
Alien 5